WWWWWWWWWWWWWWWWWWWWWWWWWWWWWWWWWWWWWWWWWWWWWWWWWWW
Wc  W       W   #####       W         WcccccccW   W
W W WWW WWW WWWWWWWWWWW WWW W WWWWWWW WWW WWWWW t W
W W   W W W           W W W   W     W     W   W   W
W WWW W W WWW###WWWWW W W WWWWW WWWWWWWWWWWWW WWW W
W WTW   W           W W W ##  W      cW       W W W
W W WWWWW WWW WWWWWWW W W W WWW WWW WWW WWW W W W W
W W         W W       W W W     W   W   W W W   W W
W W WWWWWWW WWW WWWWWWW WWWWW WWW WWW WWW W WWW W W
W WTW     W   W   W     W   W   W         W W W W W
W WWW WWW WWW WWW WWW WWW W WWW WWWWWWWWWWW W W W W
W W   W       W W  cW  A  W W   W W       W W   W W
W W WWWWWW#WW W WWW WWW WWW WWW W W WWWWW W W WWW W
W W    #W   W W   W   W   W   W   W W     W W W   W
W W W ##W WWW WWW WWW WWWWWWW WWW W WWW WWW W W WWW
W W W## W    #  W   W W  ###  W   W   W     W W W W
W W W#  WWWWWWW W W W W WW#WWWW WWWWW WWWWWWW W W W
W W W#      W   W W W   W     W   W W       ##W   W
W WWWWWWWWW W WWW WWWWWWW WWWWWWW W WWWWW W ##WWW W
W W#      W W     W     W       W   W   W W ##  W W
W W WWWWW W WWWWWWW W WWW WWWWW WWW W W WWW#WWWWW W
W###W     W         W  ###W## W     W W   W###### W
WcWWW WWWWWWWWWWWWWWWWWWWWW#W WWWWWWW WWW W#    # W
WcccW                 ######W##         W    ##   W
WWWWWWWWWWWWWWWWWWWWWWWWWWWWWWWWWWWWWWWWWWWWWWWWWWW