WWWWWWWWWWWWWWWWWWWWWWWWWWWWWWWWWWWWWWWWWWWWWWW
WWWWWWWWWWWWWWWWWWWWWWWWWWWWWWWWWWWWWWWWWWWWWWW
WW##    cccccc   W#####W     W#T#W  cc   cc  WW
WW#WWW W W#W W W W W W W W W W#W#W W W W WWW WW
WWTW#  W WTW W     W  ###  Wt      #tW W   WTWW
WW W#WWW WWW WWW WWW WWWWW WWW WWW WWW WWW W WW
WW    cc W   Wtt   W   cc  W       #tW  ###  WW
WWtW WWW WWW WWW WWW WWWWW WWW WWW WWW WWW W WW
WW W###W#W W WT    W   W   W  ##     W W   W WW
WW#WWW W#W W W WWW WWW W WWW WWW WWW W W WWW WW
WW#WcccW#W W W   W # W   W#  W   W## W W## W WW
WW## W   W   W W W##      ## W W W W W   W## WW
WW#W WWWtWWW WWW WWW WW WW WWWTWWW WWW WWW W WW
WW#W W  ####  cW     W A W     W   W ##  W W WW
WW W W WWW WWW WWW W WWWWW W WWW WWW WWW W W WW
WWT ###  W   W    cW  ##   Wc   ###  W  c    WW
WW W WWW WWW WWW WWW WWWWW WWW WWW WWW WWW W WW
WW WcccW WTW W ##  W   W   Wtc       W W   WcWW
WW WWW W W W W WWW WWW W WWW WWW WWW W W WWW WW
WW    ##  c  ### W   ####    W   W      ###  WW
WWWW W W W W WWW WWWcW W W WWW WWW WWW W W WWWW
WW   W W## W   W WcccW   W   W WTW W   W W   WW
WWTWWW WWW WWW WcWcWWWcW WWW W WcW W WWW WWWTWW
WW   ###   c           W      ###      ##    WW
WWWWWWWWWWWWWWWWWWWWWWWWWWWWWWWWWWWWWWWWWWWWWWW
WWWWWWWWWWWWWWWWWWWWWWWWWWWWWWWWWWWWWWWWWWWWWWW