WWWWWWWWWWWWWWWWWWWWWWWWWWWWWWWWWWWWWWWWWWWWWWWWWWWWW
WWWWWWWWWWWWWWWWWWWWWWWWWWWWWWWWWWWWWWWWWWWWWWWWWWWWW
WWc  W       W   #####       W         WcccccccW   WW
WW W WWW WWW WWWWWWWWWWW WWW W WWWWWWW WWW WWWWW t WW
WW W   W W W           W W W   W     W     W   W   WW
WW WWW W W WWW###WWWWW W W WWWWW WWWWWWWWWWWWW WWW WW
WW WTW   W           W W W ##  W      cW       W W WW
WW W WWWWW WWW WWWWWWW W W W WWW WWW WWW WWW W W W WW
WW W         W W       W W W     W   W   W W W   W WW
WW W WWWWWWW WWW WWWWWWW WWWWW WWW WWW WWW W WWW W WW
WW WTW     W   W   W     W   W   W         W W W W WW
WW WWW WWW WWW WWW WWW WWW W WWW WWWWWWWWWWW W W W WW
WW W   W       W W  cW  A  W W   W W       W W   W WW
WW W WWWWWW#WW W WWW WWW WWW WWW W W WWWWW W W WWW WW
WW W    #W   W W   W   W   W   W   W W     W W W   WW
WW W W ##W WWW WWW WWW WWWWWWW WWW W WWW WWW W W WWWW
WW W W## W    #  W   W W  ###  W   W   W     W W W WW
WW W W#  WWWWWWW W W W W WW#WWWW WWWWW WWWWWWW W W WW
WW W W#      W   W W W   W     W   W W       ##W   WW
WW WWWWWWWWW W WWW WWWWWWW WWWWWWW W WWWWW W ##WWW WW
WW W#      W W     W     W       W   W   W W ##  W WW
WW W WWWWW W WWWWWWW W WWW WWWWW WWW W W WWW#WWWWW WW
WW###W     W         W  ###W## W     W W   W###### WW
WWcWWW WWWWWWWWWWWWWWWWWWWWW#W WWWWWWW WWW W#    # WW
WWcccW                 ######W##         W    ##   WW
WWWWWWWWWWWWWWWWWWWWWWWWWWWWWWWWWWWWWWWWWWWWWWWWWWWWW
WWWWWWWWWWWWWWWWWWWWWWWWWWWWWWWWWWWWWWWWWWWWWWWWWWWWW